        ######## 
        #      # 
        # X#X ## 
        # X   #  
        ##X XX#  
######### X # ###
#OOO   ## X X   #
##OOOP          #
#OOO   ##########
########         