           ####     
           #  #     
           #  #     
           #  #     
           ## #     
            # #     
           ##X###   
  ##########  X ####
  #OOOO#  ## X     #
### #          X ###
#       # ## XXX #  
###O O #   # X   #  
  ###### PO####  #  
       ##  #  ####  
       ## ##        
       #   #        
       #   #        
       ### #        
         #O#        
         ###        