    #####          
    #   #          
    #X X#          
  ###   ##         
  #   X  #         
### # ## #   ######
#   # ## #####  O #
# X           P O #
##### ### # ##  OO#
    #     #########
    #######        